0,0,0,0,0,0,0,0,0,0,0,0,0,0,0,0,0,0,0,0,0,0,0,0,0,0,0,0,0,0,0,0,0,0,0,0,0,0,0,0,0,0,0,0,0,0,0,0,0,0,0,0,0,0,0,0,0,0,0,0,0,0,0,0,
0,0,0,0,0,0,0,0,0,0,0,0,0,0,0,0,0,0,0,0,0,0,0,0,0,0,0,60,53,49,57,0,0,0,0,0,0,0,0,0,48,0,0,0,0,0,50,0,0,0,0,0,0,0,0,0,0,0,0,0,0,0,0,0,
0,0,0,0,0,0,0,0,0,0,0,0,0,0,0,0,0,0,0,0,0,0,0,0,0,0,60,68,0,140,69,53,53,53,53,57,0,0,0,0,52,0,0,0,0,248,50,0,0,0,0,0,0,0,0,0,0,0,0,0,0,0,0,0,
0,0,0,0,0,0,0,0,0,0,0,0,0,0,0,0,0,0,0,0,0,0,0,0,0,0,52,245,142,0,140,246,124,0,123,69,57,0,0,0,48,0,250,0,0,66,58,0,0,0,0,0,0,0,0,0,0,0,0,0,0,0,0,0,
0,53,53,61,0,0,0,0,0,0,0,0,0,0,0,0,0,0,0,0,0,0,0,60,49,53,64,124,119,126,0,0,0,0,127,125,54,0,60,53,64,0,115,0,0,54,0,0,0,0,0,0,0,0,0,0,0,0,0,0,0,0,0,0,
0,0,116,65,53,57,0,0,0,0,0,0,0,0,0,0,0,0,0,0,0,0,56,64,119,0,0,0,0,0,125,0,0,0,244,114,65,49,68,125,116,0,0,0,0,54,0,0,0,0,0,0,0,0,0,0,0,0,0,0,0,0,0,0,
0,0,0,0,0,69,53,53,49,61,0,0,0,0,0,0,0,0,0,0,0,0,52,0,0,125,0,127,127,115,0,0,0,0,0,0,0,0,0,129,0,0,0,0,70,58,0,0,0,0,0,0,0,0,0,0,0,0,0,0,0,0,0,0,
0,0,0,114,0,0,0,0,0,69,53,61,0,0,0,0,0,0,0,0,0,0,63,67,247,0,0,0,0,0,0,0,0,0,0,0,0,0,115,114,0,128,0,0,54,0,0,0,0,0,0,0,0,0,0,0,0,0,0,0,0,0,0,0,
0,0,0,0,0,0,0,0,254,0,0,65,61,0,0,0,0,0,0,0,0,0,0,59,67,0,120,0,0,0,0,0,0,0,0,0,0,0,114,0,0,0,0,70,62,0,0,0,0,0,0,0,0,0,0,0,0,0,0,0,0,0,0,0,
0,0,0,0,0,0,0,0,0,0,0,0,65,53,57,0,0,0,0,0,0,0,0,0,48,124,127,0,0,0,115,0,124,0,0,121,0,0,0,0,0,0,0,50,0,0,0,0,0,0,0,0,0,0,0,0,0,0,0,0,0,0,0,0,
0,0,0,0,0,0,0,0,0,0,0,249,125,112,65,57,0,0,0,0,0,0,0,56,68,136,126,0,0,0,0,0,0,0,0,0,0,0,0,0,0,126,0,54,0,0,0,56,53,49,53,49,61,0,0,0,0,0,0,0,0,0,0,0,
0,0,0,0,0,0,0,0,0,0,0,0,126,0,100,65,57,0,56,230,231,53,61,52,98,101,0,0,0,115,130,0,0,0,0,0,0,0,0,0,0,0,0,54,0,0,0,52,0,0,0,0,69,53,61,0,0,0,0,0,0,0,0,0,
0,92,0,0,0,0,0,0,0,0,0,0,122,124,103,96,69,49,68,0,0,0,69,64,0,124,126,127,0,0,0,0,0,0,126,0,0,122,0,0,251,0,70,62,0,0,60,64,0,252,0,124,247,117,69,61,0,0,0,0,0,0,0,0,
0,92,127,0,0,0,0,0,0,0,0,0,0,127,126,0,0,0,97,126,0,0,73,0,73,0,0,0,0,0,0,0,0,0,0,0,0,0,0,0,0,0,69,61,0,0,48,0,115,0,127,0,0,127,0,50,0,0,0,0,0,0,0,0,
0,67,0,0,0,127,124,0,0,0,0,0,0,0,0,98,0,126,0,0,0,99,72,0,72,0,0,127,0,0,0,0,0,0,126,0,0,106,107,110,111,106,107,65,53,49,64,0,0,121,115,0,251,0,0,50,0,0,0,0,0,0,0,0,
0,59,55,67,0,0,0,0,125,130,0,0,0,0,0,0,0,0,0,0,0,0,0,0,0,127,0,0,0,124,0,0,0,0,0,0,105,113,112,113,113,113,113,113,113,113,113,105,0,0,0,0,0,0,70,58,0,0,0,0,0,0,0,0,
0,0,0,63,55,51,51,71,0,0,0,0,0,0,114,0,127,0,74,75,0,102,0,0,0,0,0,0,0,0,0,0,0,0,0,0,104,116,117,116,117,116,116,117,117,116,116,104,0,0,0,0,66,51,58,0,0,0,0,0,0,0,0,0,
0,0,0,0,0,0,0,52,0,126,0,115,0,0,0,0,0,0,0,0,0,0,0,0,74,75,0,0,0,41,0,0,0,0,0,0,0,0,0,0,0,0,0,114,114,114,115,109,0,0,253,0,54,0,0,0,0,0,0,0,0,0,0,0,
0,0,0,0,0,0,0,59,71,126,0,0,0,0,0,0,0,0,126,0,0,127,0,0,0,0,125,0,0,253,0,0,0,0,0,0,109,122,123,122,123,123,0,122,122,123,122,108,130,0,113,0,65,57,0,0,0,0,0,0,0,0,0,0,
0,0,0,0,0,0,0,0,59,67,124,0,130,0,0,0,0,0,0,0,126,0,0,0,0,0,0,0,0,0,0,0,114,114,0,0,108,121,120,121,120,121,0,121,121,120,120,105,246,114,0,0,121,69,61,0,0,0,0,0,0,0,0,0,
0,0,0,0,0,0,0,0,0,48,0,0,0,0,0,0,0,0,0,0,0,0,0,0,114,0,0,0,0,0,128,0,0,0,0,0,0,0,0,125,0,127,0,114,114,114,114,104,125,0,0,0,0,0,54,0,0,0,0,0,0,0,0,0,
0,0,0,0,0,0,0,0,56,64,0,0,0,0,0,0,0,0,0,0,0,0,0,0,0,0,0,0,0,0,0,0,0,0,0,0,0,211,0,0,127,0,0,113,113,113,113,105,0,0,0,0,0,0,69,49,57,0,0,0,0,0,0,0,
0,0,0,0,0,0,0,0,52,106,107,127,110,111,0,0,0,0,0,0,0,0,0,0,0,0,0,0,0,0,0,0,0,0,0,0,0,210,0,0,0,0,0,117,116,117,116,104,0,0,0,0,0,0,242,126,69,53,61,0,0,0,0,0,
0,0,0,0,0,0,0,0,59,67,0,124,0,0,0,0,0,0,0,0,0,0,0,0,0,0,0,0,0,0,0,0,0,0,0,0,208,209,0,0,0,0,0,123,122,123,123,105,0,113,124,0,0,0,0,0,0,0,54,0,0,0,0,0,
0,0,0,0,0,0,0,0,0,48,0,0,0,0,0,0,0,0,0,0,0,0,0,0,0,0,0,0,0,0,0,0,0,0,0,0,0,0,0,0,0,0,0,121,121,120,121,104,0,124,0,0,0,0,0,0,0,66,62,0,0,0,0,0,
0,0,0,0,0,0,56,53,53,68,0,0,0,0,0,0,0,0,0,0,0,255,0,0,0,0,0,0,0,0,0,0,0,0,0,0,0,0,0,0,124,0,0,110,111,106,107,0,0,0,115,118,124,0,0,0,0,54,0,0,0,0,0,0,
0,0,0,0,0,0,52,0,0,0,0,0,126,0,0,0,115,0,0,0,0,0,0,0,0,0,0,0,0,0,0,114,0,0,0,0,0,0,0,0,0,0,124,0,0,0,0,0,0,0,0,0,0,112,0,0,66,62,0,0,0,0,0,0,
0,0,0,0,0,0,52,0,136,0,124,127,0,0,0,0,0,0,0,0,0,0,249,0,0,0,0,0,0,0,0,0,0,98,96,0,0,0,0,128,114,0,120,0,121,125,0,124,0,242,0,0,70,67,0,70,62,0,0,0,0,0,0,0,
0,0,0,0,0,56,64,0,106,107,0,0,124,0,0,0,0,0,0,0,0,0,76,0,0,0,0,0,0,0,0,0,0,0,0,0,0,0,0,0,0,0,0,117,125,130,0,0,0,126,127,128,54,63,55,62,0,0,0,0,0,0,0,0,
0,0,0,0,0,48,0,0,0,98,105,125,0,0,0,0,0,0,0,0,0,0,0,0,0,0,0,0,0,0,0,0,168,169,170,0,0,0,0,0,0,0,0,0,126,0,0,0,0,0,120,0,65,61,0,0,0,0,0,0,0,0,0,0,
0,0,0,0,56,64,124,0,0,0,104,0,0,127,0,0,131,0,0,0,0,0,0,0,0,0,0,0,0,114,0,0,0,0,0,0,0,0,0,0,0,0,0,0,0,121,0,0,0,0,0,125,0,65,57,0,0,0,0,0,0,0,0,0,
0,0,0,0,48,128,0,0,0,0,211,0,0,124,0,0,0,0,0,0,0,0,0,0,0,0,0,0,255,0,0,0,0,0,0,0,0,0,0,0,0,0,0,0,0,0,0,0,124,240,0,0,0,126,69,57,0,0,0,0,0,0,0,0,
0,0,0,56,68,0,0,0,0,0,210,0,125,0,0,0,0,0,0,116,0,0,0,253,0,0,0,0,0,0,0,0,0,0,0,0,0,0,0,0,0,0,0,0,0,0,130,0,114,0,0,0,0,0,0,54,0,0,0,0,0,0,0,0,
0,0,0,52,0,0,0,0,0,208,209,0,0,125,0,0,0,0,0,0,0,0,0,0,0,0,0,114,0,0,0,0,0,0,0,0,0,0,0,0,0,0,0,0,0,0,0,0,0,114,0,117,251,0,116,69,61,0,0,0,0,0,0,0,
0,0,0,59,67,0,0,0,0,100,101,0,125,0,126,0,0,0,0,0,0,0,0,0,0,0,0,0,0,0,0,0,0,0,0,0,0,0,131,0,0,0,0,125,0,0,0,0,0,0,0,0,0,0,126,0,54,0,0,0,0,0,0,0,
0,0,0,0,48,0,0,0,0,0,0,124,0,127,0,0,124,0,0,0,0,0,0,0,0,0,0,115,0,0,0,0,0,0,0,0,0,0,0,0,0,0,0,0,128,0,124,0,0,0,0,0,0,0,0,113,69,61,0,0,0,0,0,0,
0,0,0,0,59,71,0,136,125,0,0,0,137,0,0,0,0,0,0,0,0,0,98,0,0,0,0,0,0,0,0,0,0,0,0,0,0,0,0,0,0,0,0,127,0,0,245,128,0,0,0,0,0,0,0,0,0,54,0,0,0,0,0,0,
0,0,0,0,0,52,0,0,0,0,0,127,0,0,0,0,127,125,0,0,0,0,215,0,0,0,0,0,0,0,0,0,0,0,0,0,0,0,0,0,0,0,0,252,0,127,124,0,0,0,0,0,0,0,131,0,0,50,0,0,0,0,0,0,
0,0,0,0,0,63,51,71,0,0,0,0,0,127,0,0,0,124,0,0,212,213,214,103,0,0,0,0,0,0,0,0,0,0,0,0,0,0,0,0,109,254,0,0,0,0,0,125,0,0,129,0,0,0,0,0,0,50,0,0,0,0,0,0,
0,0,0,0,0,0,0,0,71,0,0,0,0,0,0,0,0,0,0,0,0,0,0,0,0,0,0,0,0,0,0,0,0,0,0,0,0,0,0,0,108,0,0,127,126,0,0,124,0,0,127,0,0,0,0,112,124,65,57,0,0,0,0,0,
0,0,0,0,0,0,0,0,48,0,136,0,0,0,0,0,0,0,0,0,0,0,0,0,0,0,0,125,0,0,0,0,0,127,0,0,0,0,0,125,133,0,0,0,0,0,128,0,0,0,247,124,0,0,0,0,0,0,54,0,0,0,0,0,
0,0,0,0,0,0,0,0,59,71,126,0,0,0,0,0,0,211,0,0,0,0,0,0,0,0,0,0,0,0,0,0,0,0,0,0,0,0,0,0,0,0,0,0,0,0,0,0,126,0,0,125,0,0,0,0,0,70,58,0,0,0,0,0,
0,0,0,0,0,0,0,0,56,68,0,128,113,0,0,0,0,210,0,0,0,102,0,0,0,0,0,0,0,0,0,124,0,0,0,0,0,0,0,0,0,0,0,0,0,0,0,0,0,0,0,245,0,0,0,0,0,65,57,0,0,0,0,0,
0,0,0,0,0,0,0,0,48,0,0,0,127,0,0,0,208,209,0,0,0,0,0,0,0,74,75,0,0,125,0,0,0,0,0,0,0,0,0,0,0,0,125,0,0,0,0,0,124,0,126,0,125,0,115,0,0,0,50,0,0,0,0,0,
0,0,0,0,0,0,0,0,48,0,0,0,0,0,127,0,0,96,0,0,0,0,0,0,0,0,0,0,0,0,0,0,0,0,0,0,127,125,0,0,135,0,0,126,0,0,0,0,0,0,0,0,127,0,0,0,0,0,50,0,0,0,0,0,
0,0,0,0,0,0,0,0,48,112,245,0,0,244,123,0,0,126,0,0,73,0,0,0,0,0,0,127,0,0,0,0,0,118,127,0,249,0,127,0,105,0,0,0,0,0,0,0,0,0,0,0,0,0,125,0,0,0,65,57,0,0,0,0,
0,0,0,0,0,0,0,0,59,71,0,0,245,249,136,0,0,112,0,0,72,0,0,73,125,0,124,0,0,125,0,0,0,0,0,0,0,0,0,0,104,0,0,0,0,0,0,0,0,0,0,0,0,0,0,0,0,0,0,65,61,0,0,0,
0,0,0,0,0,0,0,0,0,52,0,0,0,0,129,0,0,0,0,122,0,0,96,72,0,0,127,127,125,0,0,0,125,0,0,0,0,66,55,71,0,126,0,0,0,0,0,0,0,0,0,0,0,251,0,0,0,0,0,0,50,0,0,0,
0,0,0,0,0,0,0,0,0,52,0,0,0,0,0,123,127,0,130,127,0,126,0,0,0,0,0,0,125,115,0,0,0,0,254,0,0,54,0,59,71,0,244,0,0,0,0,0,0,124,124,0,0,0,0,0,0,0,120,128,69,57,0,0,
0,0,0,0,0,0,0,0,0,59,67,241,0,254,0,0,127,136,0,0,0,0,0,0,0,0,0,114,0,122,0,124,0,117,0,0,70,62,0,0,59,67,0,0,0,0,0,0,0,0,0,0,0,0,0,0,0,0,127,126,0,54,0,0,
0,0,0,0,0,0,0,0,0,0,63,71,0,124,0,251,0,0,0,0,0,126,0,0,125,123,136,0,0,0,0,123,123,0,0,0,54,0,0,0,0,63,51,67,0,253,0,0,0,0,0,0,0,0,115,0,0,0,0,0,0,50,0,0,
0,0,0,0,0,0,0,0,0,0,0,59,55,67,255,0,0,0,0,0,0,0,0,240,128,125,0,126,0,70,51,67,0,0,0,70,62,0,0,0,0,0,0,48,0,0,0,0,0,0,0,127,0,0,0,0,0,0,114,125,116,65,61,0,
0,0,0,0,0,0,0,0,0,0,0,0,0,59,67,124,0,0,248,0,0,0,0,0,0,0,120,0,0,54,0,63,55,51,55,62,0,0,0,0,0,0,0,52,123,0,0,0,0,0,0,0,130,125,0,0,0,0,0,0,0,0,54,0,
0,0,0,0,0,0,0,0,0,0,0,0,0,0,59,71,0,0,0,112,0,243,0,70,51,51,67,0,0,50,0,0,0,0,0,0,0,0,0,0,0,0,0,52,126,0,0,0,0,0,0,0,0,0,0,0,0,0,0,0,0,0,50,0,
0,0,0,0,0,0,0,0,0,0,0,0,0,0,0,52,0,0,252,0,0,0,0,54,0,0,63,55,55,58,0,0,0,0,0,0,0,0,0,0,0,0,60,64,126,0,0,0,0,0,127,0,0,0,0,0,0,0,0,0,247,0,54,0,
0,0,0,0,0,0,0,0,0,0,0,0,0,0,0,63,67,246,0,0,0,66,55,62,0,0,0,0,0,0,0,0,0,0,0,0,0,0,0,0,0,0,48,0,0,0,0,0,0,0,0,0,0,0,0,0,0,0,124,0,124,0,50,0,
0,0,0,0,0,0,0,0,0,0,0,0,0,0,0,0,59,55,51,55,51,58,0,0,0,0,0,0,0,0,0,0,0,0,0,0,0,0,0,0,0,60,64,0,0,0,0,138,0,0,0,241,0,131,0,0,0,0,126,117,0,0,54,0,
0,0,0,0,0,0,0,0,0,0,0,0,0,0,0,0,0,0,0,0,0,0,0,0,0,0,0,0,0,0,0,0,0,0,0,0,0,0,0,0,0,48,253,0,0,0,0,0,127,0,0,0,0,0,0,0,0,0,128,0,0,0,50,0,
0,0,0,0,0,0,0,0,0,0,0,0,0,0,0,0,0,0,0,0,0,0,0,0,0,0,0,0,0,0,0,0,0,0,0,0,0,0,0,0,0,52,0,115,126,0,0,0,0,0,0,0,0,0,0,0,0,0,254,0,0,66,62,0,
0,0,0,0,0,0,0,0,0,0,0,0,0,0,0,0,0,0,0,0,0,0,0,0,0,0,0,0,0,0,0,0,0,0,0,0,0,0,0,0,0,63,71,0,0,0,0,0,0,0,0,114,0,0,0,0,126,112,0,0,0,54,0,0,
0,0,0,0,0,0,0,0,0,0,0,0,0,0,0,0,0,0,0,0,0,0,0,0,0,0,0,0,0,0,0,0,0,0,0,0,0,0,0,0,0,60,68,0,0,0,127,0,0,0,0,0,0,0,128,0,0,115,0,0,70,58,0,0,
0,0,0,0,0,0,0,0,0,0,0,0,0,0,0,0,0,0,0,0,0,0,0,0,0,0,0,0,0,0,0,0,0,0,0,0,0,0,0,0,0,52,0,242,0,0,0,0,0,0,0,0,0,0,0,0,247,0,0,0,50,0,0,0,
0,0,0,0,0,0,0,0,0,0,0,0,0,0,0,0,0,0,0,0,0,0,0,0,0,0,0,0,0,0,0,0,0,0,0,0,0,0,0,0,0,63,71,0,95,95,0,0,0,0,129,0,0,0,0,0,0,0,247,125,54,0,0,0,
0,0,0,0,0,0,0,0,0,0,0,0,0,0,0,0,0,0,0,0,0,0,0,0,0,0,0,0,0,0,0,0,0,0,0,0,0,0,0,0,0,0,0,0,0,0,0,0,0,0,0,0,0,0,0,0,0,0,0,0,0,0,0,0